9 10
*,*,*,*,*,*,*,*,*,*
*,n,n,n,n,n,n,n,n,*
*,n,*,n,*,*,n,*,n,*
*,n,n,n,n,n,n,n,n,*
*,n,*,n,*,*,n,*,n,*
*,n,n,n,n,n,n,n,n,*
*,n,*,n,*,*,n,*,n,*
*,n,n,n,n,n,n,n,n,*
*,*,*,*,*,*,*,*,*,*