11,11,,,,,,,,,
w,w,w,w,w,w,w,w,w,w,w
w,`,`,`,`,`,`,`,`,`,w
w,`,w,w-d,w,w-d,w,w-d,w,`,w
w,`,w-d,`,w-d|n,`,w-d|s,`,w-d,`,w
w,`,w,w-d,w,w-d,w,w-d,w,`,w
w,`,w-d,`,w-d,w-d|d,w-d,`,w-d,`,w
w,`,w,w-d,w,w-d,w,w-d,w,`,w
w,`,w-d,`,w-d,w-d|p,w-d,`,w-d,`,w
w,`,w,w-d,w,w-d,w,w-d,w,`,w
w,`,`,`,`,`,`,`,`,`,w
w,w,w,w,w,w,w,w,w,w,w
